type octile
height 10
width 10
map
TTTTTTTTTT
Ts......TT
T.TTTTTTTT
T........T
T.T.TT..TT
T.T......T
T.T.TTTTTT
T.......TT
TTT.T.TTTT
TTTTTeTTTT

TTTTTTTTTT
TTTTTsTTTT
TTTTT.TTTT
TTTTTTTTTT
TTTTTTTTTT
TTTTTTTTTT
TTTTTTTTTT
TTTTTTTTTT
TTTTTTTTTT
TTTTTeTTTT

TTTTTTTTTT
TTTTTsTTTT
TTTTT.TTTT
TTTTT.TTTT
TTTTT.TTTT
TTTTT.TTTT
TTTTT.TTTT
TTTTT.TTTT
TTTTT.TTTT
TTTTTeTTTT

TTTTTTTTTT
T....s...T
T........T
T........T
T........T
T........T
T........T
T........T
T........T
TTTTTeTTTT
